0000000000^0000000
00^^^^^^^^^000^000
00^00000000000^^^^
00^00^^^^^^^^^^000
00^^0^00000000^^^0
000^0^^^^^^^^^^000
000^000^0000^00000
000^^^^^00^^^^^^^^
0000000000^0000000
